###########
#         #
# S       #
#         #
#   A     #
#         #
###########
