%%%%%%
%S   %
% A  %
%    %
%    %
%%%%%%
