%%%%%%%%%%%%%%%%%%%%%%
%S                  A%
%                    %
%                    %
%                    %
%                    %
%                    %
%                    %
%                    %
%                   S%
%%%%%%%%%%%%%%%%%%%%%%
