%%%%%%%%%%
%S      A%
%        %
%        %
%        %
%        %
%        %
%        %
%       S%
%%%%%%%%%%
