###########
#S        #
#         #
#         #
#   A     #
#        S#
###########
